[
    {
        "map" : [
            [0, 0, 0, 0, 0, 0, 0, 0],
            [0, 0, 2, 2, 2, 2, 0, 0],
            [0, 2, 2, 0, 0, 2, 0, 0],
            [0, 2, 5, 3, 0, 2, 0, 0],
            [0, 2, 2, 3, 0, 2, 2, 0],
            [0, 2, 2, 0, 3, 0, 2, 0],
            [0, 2, 1, 3, 0, 0, 2, 0],
            [0, 2, 1, 1, 4, 1, 2, 0],
            [0, 2, 2, 2, 2, 2, 2, 0],
            [0, 0, 0, 0, 0, 0, 0, 0]
        ],
        "size" : [8, 10]
    },
    {
        "map" : [
            [0, 0, 0, 0, 0, 0, 0, 0, 0],
            [0, 2, 2, 2, 2, 2, 0, 0, 0],
            [0, 2, 1, 0, 5, 2, 2, 2, 0],
            [0, 2, 0, 1, 4, 3, 0, 2, 0],
            [0, 2, 2, 0, 3, 0, 0, 2, 0],
            [0, 0, 2, 0, 0, 3, 0, 2, 0],
            [0, 0, 2, 1, 3, 3, 0, 2, 0],
            [0, 0, 2, 0, 0, 3, 0, 2, 0],
            [0, 0, 2, 1, 0, 0, 1, 2, 0],
            [0, 0, 2, 0, 1, 0, 2, 2, 0],
            [0, 0, 2, 2, 2, 2, 2, 0, 0],
            [0, 0, 0, 0, 0, 0, 0, 0, 0]
        ],
        "size" : [9, 12]
    },
    {
        "map" : [
            [0, 0, 0, 0, 0, 0, 0, 0, 0, 0],
            [0, 0, 2, 2, 2, 2, 2, 2, 2, 0],
            [0, 2, 2, 0, 2, 1, 0, 1, 2, 0],
            [0, 2, 0, 0, 3, 0, 1, 0, 2, 0],
            [0, 2, 0, 3, 2, 1, 3, 1, 2, 0],
            [0, 2, 0, 0, 3, 0, 1, 0, 2, 0],
            [0, 2, 2, 0, 2, 3, 0, 2, 2, 0],
            [0, 2, 0, 3, 0, 0, 2, 2, 0, 0],
            [0, 2, 0, 0, 0, 2, 2, 0, 0, 0],
            [0, 2, 5, 0, 2, 2, 0, 0, 0, 0],
            [0, 2, 2, 2, 2, 0, 0, 0, 0, 0],
            [0, 0, 0, 0, 0, 0, 0, 0, 0, 0]
        ],
        "size" : [10, 12]
    },
    {
        "map" : [
            [0, 0, 0, 0, 0, 0, 0, 0, 0, 0, 0, 0, 0, 0, 0, 0],
            [0, 0, 0, 0, 0, 0, 2, 2, 2, 2, 2, 0, 0, 0, 0, 0],
            [0, 0, 0, 0, 0, 0, 2, 0, 0, 0, 2, 2, 0, 0, 0, 0],
            [0, 0, 0, 0, 2, 2, 2, 3, 3, 0, 0, 2, 2, 0, 0, 0],
            [0, 0, 0, 0, 2, 0, 0, 0, 2, 0, 0, 0, 2, 2, 0, 0],
            [0, 0, 0, 0, 2, 0, 3, 0, 0, 0, 2, 0, 0, 2, 2, 0],
            [0, 2, 2, 2, 2, 2, 2, 0, 2, 0, 2, 2, 0, 0, 2, 0],
            [0, 2, 1, 1, 0, 0, 2, 0, 3, 0, 3, 0, 0, 0, 2, 0],
            [0, 2, 1, 1, 0, 0, 3, 0, 0, 0, 2, 2, 2, 2, 2, 0],
            [0, 2, 6, 1, 0, 0, 2, 2, 2, 2, 2, 0, 0, 0, 0, 0],
            [0, 2, 2, 2, 2, 2, 2, 0, 0, 0, 0, 0, 0, 0, 0, 0],
            [0, 0, 0, 0, 0, 0, 0, 0, 0, 0, 0, 0, 0, 0, 0, 0]
        ],
        "size" : [16, 12]
    },
    {
        "map" : [
            [0, 0, 0, 0, 0, 0, 0, 0, 0],
            [0, 2, 2, 2, 2, 2, 2, 0, 0],
            [0, 2, 0, 0, 2, 1, 2, 2, 0],
            [0, 2, 0, 3, 3, 3, 1, 2, 0],
            [0, 2, 0, 0, 3, 0, 0, 2, 0],
            [0, 2, 5, 0, 2, 1, 1, 2, 0],
            [0, 2, 2, 2, 2, 2, 2, 2, 0],
            [0, 0, 0, 0, 0, 0, 0, 0, 0]
        ],
        "size" : [9, 8]
    },
    {
        "map" : [
            [0, 0, 0, 0, 0, 0, 0, 0, 0, 0, 0, 0, 0, 0],
            [0, 0, 2, 2, 2, 2, 0, 0, 2, 2, 2, 2, 0, 0],
            [0, 2, 2, 0, 0, 2, 2, 2, 2, 0, 0, 2, 2, 0],
            [0, 2, 0, 0, 0, 0, 0, 0, 0, 3, 0, 0, 2, 0],
            [0, 2, 0, 1, 1, 2, 0, 3, 0, 0, 3, 5, 2, 0],
            [0, 2, 0, 1, 0, 2, 2, 2, 2, 3, 3, 0, 2, 0],
            [0, 2, 1, 1, 0, 2, 0, 0, 2, 0, 0, 0, 2, 0],
            [0, 2, 2, 2, 2, 2, 0, 0, 2, 2, 2, 2, 2, 0],
            [0, 0, 0, 0, 0, 0, 0, 0, 0, 0, 0, 0, 0, 0]
        ],
        "size" : [14, 9]
    },
    {
        "map" : [
            [0, 0, 0, 0, 0, 0, 0, 0],
            [0, 2, 2, 2, 2, 2, 0, 0],
            [0, 2, 0, 0, 0, 2, 2, 0],
            [0, 2, 5, 0, 0, 0, 2, 0],
            [0, 2, 2, 3, 3, 0, 2, 0],
            [0, 2, 0, 0, 3, 0, 2, 0],
            [0, 2, 2, 0, 2, 2, 2, 0],
            [0, 2, 0, 0, 0, 2, 2, 0],
            [0, 2, 2, 0, 1, 0, 2, 0],
            [0, 2, 0, 4, 0, 1, 2, 0],
            [0, 2, 0, 0, 1, 2, 2, 0],
            [0, 2, 2, 0, 0, 0, 2, 0],
            [0, 0, 2, 2, 2, 2, 2, 0],
            [0, 0, 0, 0, 0, 0, 0, 0]
        ],
        "size" : [8, 14]
    },
    {
        "map" : [
            [0, 0, 0, 0, 0, 0, 0, 0, 0, 0, 0, 0],
            [0, 2, 2, 2, 2, 2, 2, 2, 2, 2, 2, 0],
            [0, 2, 0, 0, 0, 0, 0, 0, 0, 0, 2, 0],
            [0, 2, 0, 3, 0, 3, 2, 2, 1, 0, 2, 0],
            [0, 2, 0, 2, 0, 3, 0, 0, 1, 0, 2, 0],
            [0, 2, 0, 3, 0, 2, 0, 1, 1, 0, 2, 0],
            [0, 2, 0, 2, 0, 2, 0, 6, 0, 2, 2, 0],
            [0, 2, 0, 2, 0, 2, 0, 2, 0, 0, 2, 0],
            [0, 2, 0, 2, 3, 3, 0, 2, 1, 0, 2, 0],
            [0, 2, 0, 0, 0, 0, 0, 0, 0, 0, 2, 0],
            [0, 2, 2, 2, 2, 2, 2, 2, 2, 2, 2, 0],
            [0, 0, 0, 0, 0, 0, 0, 0, 0, 0, 0, 0]
        ],
        "size" : [12, 12]
    },
    {
        "map" : [
            [0, 0, 0, 0, 0, 0, 0, 0, 0, 0, 0, 0, 0, 0],
            [0, 2, 2, 2, 2, 0, 2, 2, 2, 2, 2, 2, 2, 0],
            [0, 2, 0, 0, 2, 2, 2, 0, 0, 0, 2, 0, 2, 0],
            [0, 2, 0, 1, 3, 0, 0, 0, 0, 0, 2, 0, 2, 0],
            [0, 2, 0, 3, 1, 2, 2, 0, 0, 2, 2, 0, 2, 0],
            [0, 2, 2, 1, 3, 0, 2, 2, 0, 0, 2, 0, 2, 0],
            [0, 2, 0, 3, 1, 0, 0, 0, 0, 0, 0, 0, 2, 0],
            [0, 2, 0, 1, 3, 0, 2, 2, 2, 0, 2, 0, 2, 0],
            [0, 2, 0, 0, 0, 2, 2, 2, 0, 0, 2, 0, 2, 0],
            [0, 2, 2, 2, 2, 2, 0, 2, 0, 2, 2, 0, 2, 0],
            [0, 0, 0, 0, 0, 0, 0, 2, 0, 2, 2, 0, 2, 0],
            [0, 0, 0, 0, 0, 0, 0, 2, 0, 0, 0, 5, 2, 0],
            [0, 0, 0, 0, 0, 0, 0, 2, 2, 2, 2, 2, 2, 0],
            [0, 0, 0, 0, 0, 0, 0, 0, 0, 0, 0, 0, 0, 0]
        ],
        "size" : [14, 14]
    },
    {
        "map" : [
            [0, 0, 0, 0, 0, 0, 0, 0, 0, 0, 0, 0, 0, 0, 0],
            [0, 0, 0, 0, 0, 2, 2, 2, 2, 2, 0, 0, 0, 0, 0],
            [0, 0, 0, 0, 0, 2, 0, 0, 0, 2, 0, 0, 0, 0, 0],
            [0, 2, 2, 2, 2, 2, 0, 3, 0, 2, 2, 2, 2, 2, 0],
            [0, 2, 0, 0, 0, 2, 3, 3, 0, 1, 1, 1, 1, 2, 0],
            [0, 2, 0, 3, 0, 3, 0, 0, 0, 1, 1, 4, 1, 2, 0],
            [0, 2, 0, 3, 3, 0, 2, 3, 0, 1, 1, 1, 1, 2, 0],
            [0, 2, 0, 3, 0, 3, 0, 0, 3, 2, 2, 2, 2, 2, 0],
            [0, 2, 5, 0, 0, 2, 0, 0, 0, 2, 0, 0, 0, 0, 0],
            [0, 2, 2, 2, 2, 2, 2, 2, 2, 2, 0, 0, 0, 0, 0],
            [0, 0, 0, 0, 0, 0, 0, 0, 0, 0, 0, 0, 0, 0, 0]
        ],
        "size" : [15, 11]
    },
    {
        "map" : [
            [0, 0, 0, 0, 0, 0, 0, 0, 0, 0, 0, 0, 0, 0, 0, 0, 0],
            [0, 0, 0, 0, 0, 0, 0, 2, 2, 2, 2, 2, 2, 2, 2, 2, 0],
            [0, 0, 2, 2, 2, 2, 2, 2, 0, 0, 0, 0, 0, 0, 0, 2, 0],
            [0, 2, 2, 0, 0, 0, 0, 0, 3, 0, 0, 0, 0, 3, 0, 2, 0],
            [0, 2, 0, 0, 3, 0, 0, 0, 2, 0, 0, 3, 0, 0, 0, 2, 0],
            [0, 2, 0, 0, 2, 0, 3, 0, 6, 0, 0, 2, 0, 3, 0, 2, 0],
            [0, 2, 0, 1, 1, 1, 2, 0, 2, 0, 1, 1, 1, 2, 0, 2, 0],
            [0, 2, 0, 2, 1, 1, 0, 0, 2, 0, 2, 1, 1, 0, 0, 2, 0],
            [0, 2, 0, 3, 0, 2, 0, 0, 1, 0, 3, 0, 2, 0, 0, 2, 0],
            [0, 2, 0, 0, 0, 3, 0, 0, 2, 0, 0, 0, 3, 0, 0, 2, 0],
            [0, 2, 2, 0, 0, 0, 0, 0, 3, 0, 3, 0, 0, 0, 0, 2, 0],
            [0, 0, 2, 2, 2, 2, 2, 2, 0, 0, 0, 0, 0, 0, 0, 2, 0],
            [0, 0, 0, 0, 0, 0, 0, 2, 2, 2, 2, 2, 2, 2, 2, 2, 0],
            [0, 0, 0, 0, 0, 0, 0, 0, 0, 0, 0, 0, 0, 0, 0, 0, 0]
        ],
        "size" : [17, 14]
    },
    {
        "map" : [
            [0, 0, 0, 0, 0, 0, 0, 0, 0, 0, 0, 0, 0, 0, 0],
            [0, 2, 2, 2, 2, 2, 2, 2, 2, 2, 2, 2, 2, 2, 0],
            [0, 2, 0, 0, 0, 0, 0, 6, 0, 0, 0, 0, 0, 2, 0],
            [0, 2, 0, 0, 3, 0, 0, 4, 0, 0, 3, 0, 0, 2, 0],
            [0, 2, 0, 3, 0, 3, 0, 1, 4, 4, 1, 4, 1, 2, 0],
            [0, 2, 1, 1, 4, 1, 1, 4, 0, 0, 3, 0, 0, 2, 0],
            [0, 2, 0, 3, 3, 0, 0, 4, 0, 0, 3, 3, 0, 2, 0],
            [0, 2, 0, 0, 0, 0, 0, 1, 0, 0, 0, 0, 0, 2, 0],
            [0, 2, 2, 2, 2, 2, 2, 2, 2, 2, 2, 2, 2, 2, 0],
            [0, 0, 0, 0, 0, 0, 0, 0, 0, 0, 0, 0, 0, 0, 0]
        ],
        "size" : [15, 10]
    }
]
